XXXXXXXXXXXXXXXXXXXXXXXXXXXXXXXXXXXX
X     XXXXX                        X
X     XXXXXX             XXXX      X
X         XXXXXX        XXXXX     SX
X         XXXXXX      XXXXXXX      X
X          XXXXX     XXXXXXX       X
           XXXXX     XXXXXXXX      X
X                    XXXXXXX       X
XXXXXXXXXXXXXXXXXXXXXXXXXXXXXXXXXXXX
XXXXXXXXXXXXXXXXXXXXXXXXXXXXXXXXXXXX
XXXXXXXXXXXXXXXXXXXXXXXXXXXXXXXXXXXX
XXXXXXXXXXXXXXXXXXXXXXXXXXXXXXXXXXXX
XXXXXXXXXXXXXXXXXXXXXXXXXXXXXXXXXXXX
XXXXXXXXXXXXXXXXXXXXXXXXXXXXXXXXXXXX
XXXXXXXXXXXXXXXXXXXXXXXXXXXXXXXXXXXX