XXXXXXXXXXXXXXXXXXXXXXXXXXXXXXXXXXXX
XXX    XXXX        XX         X  X X
XXXXX  XXX XXXXX   XXXXXXXX   X   SX
X               X  XX     X  XXXXX X
X   XXXX   XXX  X  XX  X  X  XX    X
XXX     XX XXX  X  XXXXX  X  XX X XX
XXX   X               XX  X  XXXX  X
      X    X    XX  XXX   X        X
XXXXXXX    XXXXXXXXXXXX XX  XXXXXX X
XXX                 XXX  X  XXX    X
XXXXXXXXX  XXXXX   XX      XX   XXXX
XXXXXXXXX             XXXX      XXXX
XXXXXXXXX   XXXXXX   XXXXX XXXX   XX
XXXXXXXXXXXXX        XXXXX XXX  XXXX  
XXXXXXXXXXXXXXXXXXXXXXXXXXXXXXXXXXXX