0
XXX XXXXXXXXXXXXXXXXXXXXXXXXXXXXXXXXXXXXXXXX
XXX                           X        XXXXX
X XXXXXXXXXXXXXXXXXXXXXXXXXXX XXXXXXXX XXXXX
X                             X            X
X  XXXXXXX XXXXXXXXXXXXXX XXXXXXXXXXXX XXXXX
XX XX    X XX      X      XX           X  XX
XX XX XX X XX XX X X   XX XX XXXXX  XXXX  XX
XX XX XXXX XX XXXX XXXXXX XX XX XXXXXXXX  XX
XX XX   XX                XX              XX
XX XXXX XX XXXXXXXXXXXXXXXXX XXXXXXXXXXXXXXX
XX    X XX                                 X
XXXXX X XXXXXXXXXXXXXXXXXXXXXXXXX XXXXXXXXXX
XX XX                     XX            X XX
XX XX XXXX XXXXXXXXXXXXXX XX XXXXX XX XXX XX
XX XX XX   XX     X    XX XX XX    XX     XX
XX XX XX XXXXXXX XXXXX XX XX XXXXXXXXXXXXXXX
XX             X X     XX XX        S      X
XXXXXXXXXXXXXXXX X     XX    XXXXXXXXXXXXXXX
XXXXXXXXXXXXXXXXXXXXXXXXXXXXXXXXXXXXXXXXXXXX